0,0,0,0,0,0,0,0,0,0,0,0,0,0,0,0,0
0,5,5,5,2,2,2,2,2,2,5,5,5,2,5,5,0
0,5,5,5,5,5,5,2,2,2,2,2,2,2,5,5,0
0,5,5,5,3,3,5,2,5,2,4,4,4,2,2,2,0
0,5,5,3,3,3,3,2,5,2,2,2,4,2,2,2,0
0,5,5,3,3,3,3,2,5,5,2,2,4,2,2,2,0
0,5,5,5,3,3,2,2,2,2,2,2,4,4,4,4,0
0,5,5,5,1,1,1,2,2,2,2,2,4,4,4,4,0
0,5,3,5,2,1,5,5,2,2,4,4,4,4,3,3,0
0,5,3,5,2,2,5,5,1,2,4,4,4,3,3,3,0
0,5,3,2,2,2,2,1,1,1,4,4,5,3,3,3,0
0,3,3,5,5,2,2,2,2,4,4,4,3,3,3,3,0
0,3,3,5,2,2,2,2,2,5,5,5,3,3,3,3,0
0,5,5,5,5,5,2,2,4,5,5,3,3,3,3,3,0
0,5,5,5,5,5,5,2,4,4,4,3,3,3,3,3,0
0,5,5,5,5,5,5,2,4,4,4,3,3,3,3,3,0
0,0,0,0,0,0,0,0,0,0,0,0,0,0,0,0,0